D D D D D D D D D D D
D D D D D D D D D D D
D D D D D D W W W D D
D D D D D S W W W D D
D S S S S S W W W D D
D D D D D S W W W D D
D D D D D S W W W D D
D D D D D D W W W D D
D D D D D D W W W D D
D D D D D D D D D D D
D D D D D D D D D D D
