W W W W W W W W W
W D W W W W W D W
W W D W W W D W W
W W W S S D W W W
W W W S S S W W W
W W W S S S W W W
W W D W W W D W W
W D W W W W W D W
W W W W W W W W W
